NO textures/wall.png
SO textures/wall.png
WE textures/wall.png
EA textures/wall.png
F 101,124,58
C 135,206,235
111111111111111111111
100000100000000000001
100000D00000000000001
100000100000000000001
10000010000N000000001
111111111111111111111