NO ./textures/debug/n.png
SO ./textures/debug/s.png
WE ./textures/debug/w.png
EA ./textures/debug/e.png
F 220,100,0
C 225,30,0

111111
1001N1
101001
110001
100000
