NO textures/debug/n.png
SO textures/debug/s.png
WE textures/debug/w.png
EA textures/debug/e.png
F 10,100,10
C 10,10,200
1111111111111111111111111
1000000000110000000000001
1011000001110000000000001
1001000000000000000000001
111111111011000001110000011111111
1000000N0011000001110111111111111
11110111111111011100000010001
11110111111111011101010010001
11000000110101011100000010001
10000000000000001100000010001
10000000000000001101010010001
1100000111010101111101110000111
11110111 1110101 101111010001
11111111 1111111 111111111111
