NO textures/debug/n.png
SO textures/debug/s.png
WE textures/debug/w.png
EA textures/debug/e.png
F 220,100,0
C 225,30,0
11111111111111111111111
10000000000000000000001
10000000000000000000001
10000000000000000000001
10000000000000000000001
10000000000000000000001
10000000000000000000001
10000000000000000000001
10000000000000000000001
10000000000000000000001
10000000000000000000001
10000000000000000000001
10000000000000000000001
10000000000000000000001
10000000000000000000001
10000000000000000000001
10000000000000000000001
10000000000000000000001
10000000000000000000001
10000000000N00000000001
11111111111111111111111